274,274,274,274,274,274,274,274,274,274,274,274,274,274,274,274,273,274,274,274,274,274,274,274,274,274,274,274,274,274,274,273,274,274,274,274,274,274,274,274,274,274,274,274,274,274,274,274,274,274,274,274,274,274,274,274,274
274,274,274,274,274,274,274,274,274,274,274,274,274,274,274,274,274,274,274,274,274,274,274,274,410,411,411,411,411,411,412,274,274,273,274,274,274,274,274,274,274,274,274,274,274,274,274,274,274,274,274,274,274,274,274,274,274
274,274,274,274,274,274,274,274,274,274,273,274,170,188,188,171,274,274,166,274,274,274,166,410,475,396,397,397,397,398,476,411,411,412,274,274,274,274,274,274,274,274,274,274,274,274,274,274,274,274,274,274,274,274,274,274,274,274,274,274,274,274,274,274,273,274
274,274,274,274,274,274,274,274,274,274,170,188,189,268,266,187,188,188,171,274,274,274,410,475,396,446,419,419,419,445,397,397,398,476,412,274,274,274,274,274,274,274,274,274,274,274,274,271,274,274,274,274,274,274,274,274,274,274,274,274,274,274,274,274,273,274
274,274,274,274,274,170,188,188,188,188,189,267,265,264,265,264,264,244,165,166,166,166,432,396,446,419,419,419,419,419,419,419,445,398,476,411,411,412,274,274,274,274,274,274,274,274,274,274,274,274,274,274,274,274,274,274,274,274,274,274,274,274,274,274,273,274
274,274,274,274,274,167,266,268,264,266,268,264,264,268,266,264,245,244,187,171,166,166,432,418,419,419,419,419,419,419,419,419,419,445,397,398,510,476,411,412,166,166,166,166,166,166,166,166,274,274,274,274,274,274,274,274,274,274,274,274,274,274,274,274,273,274
274,274,274,274,274,167,265,266,268,265,267,265,264,266,268,265,264,265,268,165,166,166,432,418,419,419,419,485,419,419,419,419,419,419,419,420,433,433,433,434,166,166,166,166,166,166,166,166,166,274,273,274,274,274,274,274,274,274,274,274,274,274,274,274,273,274
274,274,274,274,274,192,145,267,268,265,264,268,264,245,265,245,264,266,264,165,166,166,432,440,424,419,419,419,419,419,419,423,441,441,441,442,433,507,433,434,166,166,166,166,166,166,166,166,166,274,274,274,274,274,274,274,274,274,274,274,274,274,274,274,273,274
274,274,274,274,274,274,192,144,144,145,264,264,264,264,245,264,266,264,266,165,166,166,432,510,440,441,441,441,441,441,441,442,433,433,510,433,433,433,509,434,166,166,166,166,166,166,166,166,166,274,274,274,274,274,271,274,274,274,274,274,274,274,274,274,273,274
274,274,274,274,274,274,274,274,274,192,145,264,266,268,245,264,264,264,143,193,166,166,432,508,433,433,433,433,433,433,433,509,433,433,433,433,433,433,433,434,166,166,166,166,166,166,166,166,166,274,274,274,274,274,274,274,274,274,274,274,274,274,274,274,273,274
274,274,274,274,274,274,274,274,274,274,167,268,268,267,267,264,264,143,193,166,166,166,413,414,414,414,414,414,414,415,262,262,413,414,414,414,414,414,414,415,166,166,166,166,166,166,166,166,166,274,274,274,274,274,274,274,274,274,274,274,274,274,274,274,273,274
274,274,274,274,274,274,274,274,274,274,192,145,268,266,267,264,266,165,166,166,166,166,435,436,436,436,436,436,436,437,284,284,435,436,436,436,436,436,436,437,166,166,166,166,166,166,166,166,274,271,274,274,274,274,273,274,274,274,274,274,274,274,274,274,273,274
274,274,274,274,274,274,274,274,274,274,271,167,266,266,268,264,267,187,188,188,188,188,457,458,458,458,458,458,458,459,306,306,457,458,458,458,458,458,458,459,188,188,188,188,188,188,171,166,274,274,274,274,274,274,274,274,274,274,274,274,274,274,274,274,273,274
274,274,274,274,274,274,274,274,274,274,170,189,264,265,245,264,264,264,268,245,264,245,267,268,245,268,267,268,267,266,154,156,265,267,265,264,268,264,245,264,266,245,245,264,264,143,193,274,274,274,274,274,274,274,274,274,274,274,274,274,274,274,274,274,273,274
274,274,274,274,274,274,274,274,274,274,167,267,265,267,266,245,268,245,266,244,266,264,268,265,264,268,245,245,264,264,176,178,244,245,267,244,264,264,245,265,268,245,264,264,264,165,274,274,274,274,274,274,271,274,274,274,274,274,274,274,274,274,274,274,273,274
274,274,274,274,274,274,274,274,170,188,189,265,245,266,244,266,244,266,266,264,244,265,264,268,265,245,268,244,267,265,176,178,244,267,268,267,266,264,264,265,266,245,264,264,264,165,274,252,274,274,274,274,274,274,274,274,274,274,274,274,274,274,274,274,273,274
274,274,274,274,274,274,274,274,167,267,268,244,268,265,244,267,268,267,267,265,266,265,267,245,268,267,267,265,267,244,176,178,267,264,244,264,244,265,245,244,244,244,245,264,264,187,171,166,274,274,274,274,274,274,274,274,274,274,274,274,274,274,274,274,273,274
274,274,274,274,274,274,274,170,189,267,268,265,268,244,267,268,244,265,266,244,245,244,268,244,267,267,266,267,265,245,176,178,264,266,268,264,245,244,264,267,267,264,245,264,264,264,187,171,274,274,273,274,274,274,274,274,274,274,274,274,274,274,274,274,273,274
274,274,274,274,274,274,274,167,267,265,268,244,244,265,245,266,244,267,245,245,265,264,265,265,266,266,266,267,264,266,176,178,244,268,265,265,265,244,266,245,267,267,267,268,244,264,264,187,188,171,274,274,274,274,274,274,274,274,274,274,274,274,274,274,273,274
274,274,274,274,274,274,170,189,265,245,244,245,264,244,264,245,265,268,267,267,244,264,264,267,244,266,265,265,266,268,176,178,266,267,265,244,265,264,245,264,267,265,267,264,266,244,265,264,264,165,274,274,274,274,274,274,274,274,274,274,274,274,274,274,273,274
274,274,274,274,274,170,189,267,266,267,245,268,264,264,264,265,265,266,266,266,158,221,221,221,221,221,221,221,221,221,248,178,265,268,244,267,266,245,244,245,244,265,265,245,266,264,245,265,264,165,274,274,274,274,274,274,274,274,274,274,274,274,274,274,273,274
274,274,274,274,274,167,267,265,268,267,267,245,244,264,264,265,266,245,268,266,179,267,265,268,244,245,264,267,268,267,176,178,244,264,245,245,266,244,265,265,265,267,268,244,265,267,264,268,264,165,274,274,274,274,274,274,274,274,274,274,274,274,274,274,273,274
274,274,274,274,170,189,268,267,245,268,268,245,267,267,268,265,267,245,268,158,227,244,264,267,266,268,267,264,266,266,176,203,155,155,155,155,156,266,267,244,266,267,266,267,266,267,267,244,264,165,274,274,274,274,274,274,274,274,274,274,274,274,274,274,273,274
274,274,274,274,167,244,244,244,268,244,265,245,266,245,268,265,268,245,265,179,245,264,268,244,245,268,267,264,244,267,198,199,199,199,199,182,178,265,268,266,245,266,264,244,264,245,265,244,264,165,274,274,274,274,274,274,274,274,274,274,274,274,274,274,273,274
274,274,274,274,167,244,268,244,245,267,245,266,267,266,244,267,267,267,265,179,266,267,266,266,244,265,266,265,245,266,244,267,265,267,244,176,178,244,267,265,245,244,268,265,244,268,264,268,264,165,274,274,274,274,274,274,274,274,274,274,274,274,274,274,273,274
274,274,274,274,167,267,244,265,265,265,244,245,268,266,267,265,245,245,245,179,264,245,245,266,268,264,266,265,265,267,244,268,267,244,244,176,178,245,266,244,244,268,266,244,267,265,264,244,264,165,274,274,271,274,274,274,274,274,274,274,274,274,274,274,273,274
274,274,274,274,167,265,245,267,245,265,267,266,265,244,268,267,265,267,265,179,268,266,266,268,244,268,266,267,245,265,268,267,265,267,266,176,178,268,267,245,268,266,265,267,264,266,268,266,143,193,274,274,274,274,274,274,274,274,274,274,274,274,274,274,273,274
274,274,274,166,167,267,245,265,267,265,265,245,267,245,265,265,266,244,267,179,268,265,266,266,266,266,268,267,266,244,244,244,244,244,268,176,203,155,156,268,265,267,265,245,265,264,267,264,165,274,274,274,274,274,274,274,274,274,274,274,274,274,274,274,273,274
274,274,274,274,192,145,267,245,266,244,265,245,266,268,245,267,268,266,245,179,244,267,266,245,267,267,245,268,264,265,245,264,266,266,264,198,199,182,178,244,268,265,245,265,245,266,244,264,165,274,274,252,274,274,274,274,274,274,274,274,274,274,274,274,273,274
274,274,274,274,274,167,265,268,244,268,245,265,244,245,267,267,265,265,264,179,267,267,264,267,267,268,265,264,267,265,265,266,266,265,244,268,244,176,178,265,245,267,268,265,245,268,264,143,193,274,274,274,274,274,274,274,274,274,274,274,274,274,274,274,273,274
274,274,274,274,274,167,245,266,245,267,245,268,267,265,268,245,268,268,244,179,264,267,265,244,265,266,268,268,267,245,264,244,245,265,266,264,267,176,178,265,266,268,268,268,267,264,143,193,274,274,274,274,274,274,274,274,274,274,274,274,274,274,274,274,273,274
274,274,274,274,274,167,265,244,268,267,267,265,266,265,264,268,244,268,265,224,222,264,268,245,245,267,264,265,245,244,267,266,267,244,265,244,266,176,178,245,244,266,264,264,143,144,193,274,274,274,274,274,274,274,274,274,274,274,274,274,274,274,274,274,273,274
274,274,274,274,274,192,144,145,265,244,244,245,265,268,265,268,265,266,268,264,266,245,268,264,244,267,268,268,267,267,244,244,264,267,245,267,266,176,178,268,268,265,264,143,193,274,274,274,274,38,56,39,274,274,274,274,274,274,274,274,274,274,274,274,273,274
274,274,274,274,274,274,274,192,145,268,265,245,268,267,244,264,244,244,268,264,266,265,264,268,264,264,266,265,266,245,245,268,265,264,264,264,264,198,200,264,264,264,143,193,274,274,271,274,38,57,23,33,274,274,274,274,274,274,274,274,274,274,274,274,273,274
274,274,274,274,274,274,274,274,192,145,265,267,267,266,245,268,268,267,265,264,268,267,264,267,268,268,244,265,245,244,244,264,264,264,143,144,144,286,288,144,144,144,193,274,274,274,274,38,57,23,23,33,274,274,274,274,274,274,274,274,274,274,274,274,273,274
274,274,274,274,274,274,274,274,274,192,144,145,267,266,265,264,244,244,266,266,266,244,268,245,265,268,245,264,267,265,264,264,143,144,193,274,274,308,310,274,274,252,274,274,274,274,38,57,23,23,23,33,274,274,274,274,274,274,274,274,274,274,274,274,273,274
274,274,274,274,274,274,274,274,274,274,274,192,144,145,266,265,245,244,264,267,244,265,264,267,268,244,264,266,267,265,264,143,193,274,274,274,274,308,310,274,274,274,274,274,38,56,57,23,23,23,23,33,274,252,274,274,274,274,274,274,274,274,274,274,273,274
274,274,274,274,274,274,274,274,274,274,274,274,274,167,266,266,268,264,267,266,265,244,266,266,267,245,244,245,267,265,143,193,274,274,252,274,274,308,310,274,271,274,38,56,57,23,23,23,23,23,23,33,274,274,274,274,274,274,274,274,274,274,274,274,273,274
274,274,274,274,274,274,274,273,274,274,274,274,274,167,245,245,266,265,268,266,265,268,268,267,244,268,245,244,245,264,165,271,274,274,38,56,56,330,332,56,56,56,57,23,23,23,23,23,23,23,23,33,274,274,274,274,274,274,274,274,274,274,274,274,273,274
274,274,274,274,274,274,274,274,274,274,274,274,274,167,264,244,268,265,265,245,245,267,267,267,264,267,265,267,264,143,193,274,274,274,35,27,46,112,114,44,28,23,23,23,23,23,23,23,23,23,23,55,39,274,274,274,274,274,274,274,274,274,274,274,273,274
274,274,274,274,274,274,274,274,274,274,274,274,274,192,145,264,264,244,244,244,245,267,244,245,245,244,264,264,143,193,274,274,274,38,57,24,112,110,113,110,22,23,23,23,23,23,23,23,23,23,23,23,33,274,274,274,274,274,274,274,274,274,274,274,273,274
274,274,274,274,274,274,274,274,274,274,274,271,274,274,192,145,264,264,265,268,244,265,245,245,264,143,144,144,193,274,274,273,38,57,23,24,110,111,110,0,50,23,23,23,27,45,45,28,23,23,23,23,33,274,274,274,274,274,274,274,274,274,274,274,273,274
274,274,274,274,274,274,274,274,274,274,274,274,274,274,274,192,145,264,267,245,265,268,268,268,264,165,274,274,271,274,274,38,57,23,23,49,2,114,0,50,23,23,27,45,46,110,114,44,28,23,23,11,61,274,274,274,274,274,274,274,274,274,274,274,273,274
274,274,274,274,274,274,274,274,274,274,274,274,274,274,274,274,192,144,144,144,144,144,144,144,144,193,274,274,274,274,38,57,23,23,23,23,49,1,50,23,23,23,24,110,112,114,114,112,22,23,23,33,274,274,274,274,274,274,274,274,274,274,274,274,273,274
274,274,274,274,274,274,274,274,274,274,274,274,274,274,274,274,274,274,274,274,274,274,274,274,274,274,274,274,34,38,57,23,23,23,23,23,23,23,23,23,23,23,49,2,110,112,111,0,50,23,23,33,274,274,274,274,274,274,274,274,274,274,274,274,273,274
274,274,274,274,274,274,274,274,274,274,274,274,274,274,274,271,274,274,274,274,273,274,273,274,274,274,274,273,274,35,23,23,23,23,23,23,23,23,23,23,23,23,23,49,1,1,1,50,23,23,11,61,274,274,274,274,274,274,274,274,274,274,274,274,273,274
274,274,274,274,274,274,274,274,274,274,274,274,274,274,274,274,274,274,274,274,274,274,274,274,271,274,274,274,274,60,12,12,12,12,13,23,23,11,12,13,23,23,23,23,23,23,23,23,23,23,33,274,252,274,274,274,274,274,274,274,274,274,274,273,274
274,274,274,274,274,274,274,274,274,274,274,274,273,274,274,274,274,274,274,252,274,274,274,274,274,274,274,274,271,274,274,274,274,274,60,12,12,61,34,60,12,12,12,12,12,12,12,13,23,11,61,274,274,274,274,274,274,274,274,274,274,274,274,274,273,274
274,274,274,274,274,274,274,274,274,274,274,274,274,274,274,274,274,274,274,274,274,274,274,274,274,274,274,274,274,274,274,274,274,274,274,274,274,252,274,274,274,274,274,274,274,274,274,60,12,61,274,274,274,274,274,274,274
274,274,274,274,274,274,274,274,274,274,274,274,274,274,274,274,274,274,274,274,274,274,274,274,274,273,274,274,274,274,274,274,274,274,274,274,274,274,274,274,274,274,274,274,274,274,274,274,274,274,274,274,274,274,274,274,274
274,274,274,274,274,274,274,274,274,274,274,274,274,274,274,274,274,274,274,274,274,274,274,274,274,273,274,274,274,274,274,274,274,274,274,274,274,274,274,274,274,274,274,274,274,274,274,274,274,274,274,274,274,274,274,274,274
274,274,274,274,274,274,274,274,274,274,274,274,274,274,274,274,274,274,274,274,274,274,274,274,274,273,274,274,274,274,274,274,274,274,274,274,274,274,274,274,274,274,274,274,274,274,274,274,274,274,274,274,274,274,274,274,274
274,274,274,274,274,274,274,274,274,274,274,274,274,274,274,274,274,274,274,274,274,274,274,274,274,273,274,274,274,274,274,274,274,274,274,274,274,274,274,274,274,274,274,274,274,274,274,274,274,274,274,274,274,274,274,274,274
274,274,274,274,274,274,274,274,274,274,274,274,274,274,274,274,274,274,274,274,274,274,274,274,274,273,274,274,274,274,274,274,274,274,274,274,274,274,274,274,274,274,274,274,274,274,274,274,274,274,274,274,274,274,274,274,274
274,274,274,274,274,274,274,274,274,274,274,274,274,274,274,274,274,274,274,274,274,274,274,274,274,273,274,274,274,274,274,274,274,274,274,274,274,274,274,274,274,274,274,274,274,274,274,274,274,274,274,274,274,274,274,274,274
274,274,274,274,274,274,274,274,274,274,274,274,274,274,274,274,274,274,274,274,274,274,274,274,274,273,274,274,274,274,274,274,274,274,274,274,274,274,274,274,274,274,274,274,274,274,274,274,274,274,274,274,274,274,274,274,274
274,274,274,274,274,274,274,274,274,274,274,274,274,274,274,274,274,274,274,274,274,274,274,274,274,273,274,274,274,274,274,274,274,274,274,274,274,274,274,274,274,274,274,274,274,274,274,274,274,274,274,274,274,274,274,274,274
274,274,274,274,274,274,274,274,274,274,274,274,274,274,274,274,274,274,274,274,274,274,274,274,274,273,274,274,274,274,274,274,274,274,274,274,274,274,274,274,274,274,274,274,274,274,274,274,274,274,274,274,274,274,274,274,274
274,274,274,274,274,274,274,274,274,274,274,274,274,274,274,274,274,274,274,274,274,274,274,274,274,273,274,274,274,274,274,274,274,274,274,274,274,274,274,274,274,274,274,274,274,274,274,274,274,274,274,274,274,274,274,274,274
274,274,274,274,274,274,274,274,274,274,274,274,274,274,274,274,274,274,274,274,274,274,274,274,274,273,274,274,274,274,274,274,274,274,274,274,274,274,274,274,274,274,274,274,274,274,274,274,274,274,274,274,274,274,274,274,274

